*********************************
*        			*
*        			*
*      				*
*				*
*				*
*                               *
*                               *
*                               *
*                               *
*                               *
*                               *
*                               *
*                               *
*                               *
*                               *
*				*
*				*
*				*
*********************************