*******************************
*                             *
*                             *
*                             *
*                             *
*                             *
*                             *
*                             *
*                             *
*                             *
*                             *
*                             *
*                             *
*                             *
*                             *
*                             *
*                             *
*                             *
*                             *
*******************************